###################################
#     | [=] |     | [=] |         #
#     |     |     |     |         #
P                                 #
#                                 #
#                                 #
#                                 #
#                                 #
#                                 #
###################################